50
29
1 100 4 1 100 1 1 100 1 1 100 1 1 1 4 1 100 1 1 100 1 1 100 1 1 100 1 1 100 1 1 100 1 1 100 1 1 100 1 1 100 1 1 100 4 1 4 1 1 4
1 100 100 0 0 0 0 100 0 0 0 0 0 0 0 0 0 0 0 0 0 0 0 0 0 0 0 0 0 0 0 0 0 0 0 0 0 0 0 0 0 100 0 0 0 0 0 0 100 100
1 100 99 99 99 99 99 99 99 99 99 99 99 99 99 99 99 99 99 99 99 99 99 99 99 99 99 99 99 99 99 99 99 99 99 99 99 99 99 99 99 99 99 99 99 99 99 99 99 99
1 0 99 99 99 99 99 99 99 99 99 99 99 99 99 99 99 99 99 99 99 99 99 99 99 99 99 99 99 99 99 99 99 99 99 99 99 99 99 99 99 99 99 99 99 99 99 99 99 99
1 0 99 99 4 100 6 100 6 0 5 5 5 5 5 5 2 6 6 6 6 6 6 6 6 6 100 100 100 100 100 100 100 100 0 0 100 4 4 4 4 4 4 4 4 4 3 4 3 3
1 0 99 99 4 100 100 100 100 100 5 11 100 30 100 100 6 6 6 2 100 100 100 100 100 100 100 100 100 30 100 100 2 100 100 0 100 6 100 6 6 6 100 100 100 100 3 3 3 4
1 0 99 99 100 4 100 100 100 100 5 0 100 100 100 100 100 100 100 100 100 100 100 100 100 100 6 2 100 100 2 100 100 2 3 3 100 100 3 100 100 100 100 3 100 100 100 100 100 100
1 0 99 99 100 100 100 100 100 100 100 0 100 0 100 100 2 100 100 5 5 5 5 5 5 5 3 100 2 100 2 100 100 100 0 0 100 6 100 100 3 100 100 100 3 3 3 3 3 3
1 0 99 99 100 100 100 100 100 100 100 100 100 4 100 100 100 100 5 100 5 5 5 4 100 5 3 3 100 100 100 100 100 100 100 100 100 6 100 3 3 3 3 3 0 0 0 100 100 99
99 0 99 99 100 100 30 4 100 6 5 5 100 100 100 100 100 100 100 100 5 5 100 30 100 3 3 100 100 100 100 100 100 100 100 100 100 6 3 3 0 0 0 0 0 0 4 0 100 99
99 99 99 99 100 100 4 4 100 6 5 5 100 100 4 100 100 100 100 100 100 100 100 30 100 3 6 100 100 100 100 100 100 100 100 100 100 100 100 3 0 100 4 1 1 1 1 1 1 100
99 4 4 99 100 100 100 100 100 6 5 5 100 100 100 100 100 100 100 100 100 100 100 100 100 3 100 3 100 100 100 100 18 100 4 100 100 100 100 3 0 4 0 99 100 100 100 100 100 100
99 7 100 7 100 100 100 100 100 100 5 5 100 100 30 100 18 100 18 100 100 100 100 100 100 100 3 100 100 100 18 100 100 100 0 100 4 6 100 3 0 100 0 99 99 99 99 99 99 99
99 100 100 100 8 100 100 100 100 5 5 5 5 100 100 100 100 100 100 18 100 100 100 100 100 100 3 3 6 100 100 100 18 100 100 100 4 6 100 3 100 100 100 100 100 100 100 100 100 99
99 7 100 7 100 100 100 100 100 5 5 11 100 100 18 100 40 100 100 100 2 2 100 18 100 100 3 100 100 100 100 100 100 100 100 100 100 6 100 3 3 100 100 100 100 100 100 100 100 99
99 4 4 100 100 100 100 100 100 5 100 100 100 100 100 100 100 5 100 100 2 2 100 100 18 100 3 100 100 100 100 18 100 18 100 30 100 6 3 3 3 3 100 100 100 18 100 18 100 99
1 99 99 99 4 100 100 100 100 5 100 100 100 4 100 2 5 100 5 2 100 100 100 18 100 100 3 3 100 100 100 100 100 100 100 0 100 100 6 3 3 100 100 18 100 100 4 100 100 99
1 0 99 99 4 100 100 100 100 5 5 100 100 4 5 5 5 5 5 5 5 5 100 100 100 100 3 3 100 100 100 0 100 100 100 100 100 6 100 3 3 100 100 100 1 1 1 1 1 1
1 0 99 99 4 100 100 100 100 5 2 100 100 4 4 100 100 100 100 100 100 100 100 100 100 100 3 3 3 100 100 100 100 100 100 100 100 6 100 3 0 100 100 99 100 100 100 100 100 100
1 0 99 99 100 100 100 100 4 5 100 100 100 100 100 4 100 100 100 100 100 100 100 100 100 3 4 100 3 3 100 100 100 100 100 100 100 6 3 3 100 100 100 99 99 99 99 99 99 99
1 0 99 99 100 100 100 100 4 5 5 11 6 100 100 100 100 100 100 100 100 100 100 100 5 5 4 4 4 3 100 100 100 100 18 100 100 3 3 100 100 100 0 100 100 0 0 0 100 99
1 0 99 99 100 100 8 100 4 5 100 100 6 100 100 100 100 100 100 100 100 100 100 100 5 100 4 100 100 11 3 100 100 100 100 100 100 3 100 100 100 100 6 6 6 100 4 4 4 99
1 0 99 99 100 100 100 100 100 5 100 100 100 100 100 8 100 100 100 100 5 5 5 5 5 100 100 100 100 100 3 100 100 100 18 100 6 3 100 100 30 100 6 100 100 6 3 4 4 99
1 0 99 99 100 100 100 100 100 5 5 5 5 5 100 100 100 100 100 6 6 6 100 100 100 4 100 100 100 100 3 3 100 6 100 100 100 100 100 100 100 0 6 3 3 6 6 6 3 99
1 0 99 99 100 100 100 100 100 100 100 100 100 100 100 100 100 100 100 6 6 3 100 100 100 100 100 4 100 11 3 3 100 100 100 100 100 30 100 100 100 0 6 100 3 22 22 22 22 22
1 100 99 99 8 100 100 100 100 100 100 100 100 8 100 100 100 100 100 100 100 100 100 100 100 100 4 4 100 100 3 3 11 100 100 100 100 100 100 18 100 0 100 6 3 100 100 100 100 100
1 100 99 99 4 4 4 4 4 4 4 4 4 4 4 4 4 100 4 4 100 4 4 100 100 100 100 100 100 11 3 11 100 100 100 18 100 100 100 100 30 100 100 6 3 3 3 3 3 3
1 1 1 1 1 1 1 1 1 1 1 1 1 1 1 1 1 1 1 1 1 1 1 1 1 1 1 1 1 1 12 1 1 1 1 1 1 1 1 1 1 1 1 1 1 1 1 1 1 99
99 100 100 100 100 100 1 1 1 1 1 1 1 1 1 1 1 1 1 1 1 1 100 99 99 99 99 1 1 1 1 1 1 1 1 100 100 100 100 100 100 100 100 100 100 99 99 99 99 100